111111111111111111111111111111111111111111111111111111111111111111111111111111111111111111111111111111111111111111111111
1E1C0000C0000C0111111111111111111111111111111111111111111111111111111100000000000000000000000000000000000000000000011111
101000C0000P001000000000000000000000000000000000000000000000000000000000000000000000000000000000000000000000000000011111
1C0001111111111000000000000000000000000000000000000000000000000000000100000000000000000000000000000000000000000000011111
101111C00000000000000000000000000000000000000000000000000000000000000000000000000000000000000000000000000000000000011111
100001111111101111111111111111111111111111111111111111111111111111111100000000000000000000000000000000000000000000011111
1001000000000C1111111111111111111111111111111111111111111111111111111100000000000000000000000000000000000000000000011111
101C0000C0000C0111111111111111111111111111111111111111111111111111111100000000000000000000000000000000000000000000011111
101C0000C0000C0111111111111111111111111111111111111111111111111111111100000000000000000000000000000000000000000000011111
101C0000C0000C0111111111111111111111111111111111111111111111111111111100000000000000000000000000000000000000000000011111
101C0000C0000C0111111111111111111111111111111111111111111111111111111100000000000000000000000000000000000000000000011111
101C0000C0000C0111111111111111111111111111111111111111111111111111111100000000000000000000000000000000000000000000011111
101C0000C0000C0111111111111111111111111111111111111111111111111111111100000000000000000000000000000000000000000000011111
101C0000C0000C0111111111111111111111111111111111111111111111111111111100000000000000000000000000000000000000000000011111
101C0000C0000C0111111111111111111111111111111111111111111111111111111100000000000000000000000000000000000000000000011111
101C0000C0000C0111111111111111111111111111111111111111111111111111111100000000000000000000000000000000000000000000011111
101C0000C0000C0111111111111111111111111111111111111111111111111111111100000000000000000000000000000000000000000000011111
101C0000C0000C0111111111111111111111111111111111111111111111111111111100000000000000000000000000000000000000000000011111
1001000000000C1111111111111111111111111111111111111111111111111111111100000000000000000000000000000000000000000000011111
101C0000C0000C0111111111111111111111111111111111111111111111111111111100000000000000000000000000000000000000000000011111
101C0000C0000C0111111111111111111111111111111111111111111111111111111100000000000000000000000000000000000000000000011111
101C0000C0000C0111111111111111111111111111111111111111111111111111111100000000000000000000000000000000000000000000011111
101C0000C0000C0111111111111111111111111111111111111111111111111111111100000000000000000000000000000000000000000000011111
101C0000C0000C0111111111111111111111111111111111111111111111111111111100000000000000000000000000000000000000000000011111
101C0000C0000C0111111111111111111111111111111111111111111111111111111100000000000000000000000000000000000000000000011111
101C0000C0000C0111111111111111111111111111111111111111111111111111111100000000000000000000000000000000000000000000011111
101C0000C0000C0111111111111111111111111111111111111111111111111111111100000000000000000000000000000000000000000000011111
101C0000C0000C0111111111111111111111111111111111111111111111111111111100000000000000000000000000000000000000000000011111
101C0000C0000C0111111111111111111111111111111111111111111111111111111100000000000000000000000000000000000000000000011111
101C0000C0000C0111111111111111111111111111111111111111111111111111111100000000000000000000000000000000000000000000011111
1001000000000C1111111111111111111111111111111111111111111111111111111100000000000000000000000000000000000000000000011111
101C0000C0000C0111111111111111111111111111111111111111111111111111111100000000000000000000000000000000000000000000011111
101C0000C0000C0111111111111111111111111111111111111111111111111111111100000000000000000000000000000000000000000000011111
101C0000C0000C0111111111111111111111111111111111111111111111111111111100000000000000000000000000000000000000000000011111
101C0000C0000C0111111111111111111111111111111111111111111111111111111100000000000000000000000000000000000000000000011111
101C0000C0000C0111111111111111111111111111111111111111111111111111111100000000000000000000000000000000000000000000011111
101C0000C0000C0111111111111111111111111111111111111111111111111111111100000000000000000000000000000000000000000000011111
101C0000C0000C0111111111111111111111111111111111111111111111111111111100000000000000000000000000000000000000000000011111
101C0000C0000C0111111111111111111111111111111111111111111111111111111100000000000000000000000000000000000000000000011111
101C0000C0000C0111111111111111111111111111111111111111111111111111111100000000000000000000000000000000000000000000011111
101C0000C0000C0111111111111111111111111111111111111111111111111111111100000000000000000000000000000000000000000000011111
101C0000C0000C0111111111111111111111111111111111111111111111111111111100000000000000000000000000000000000000000000011111
1001000000000C1111111111111111111111111111111111111111111111111111111100000000000000000000000000000000000000000000011111
101C0000C0000C0111111111111111111111111111111111111111111111111111111100000000000000000000000000000000000000000000011111
101C0000C0000C0111111111111111111111111111111111111111111111111111111100000000000000000000000000000000000000000000011111
101C0000C0000C0111111111111111111111111111111111111111111111111111111100000000000000000000000000000000000000000000011111
101C0000C0000C0111111111111111111111111111111111111111111111111111111100000000000000000000000000000000000000000000011111
101C0000C0000C0111111111111111111111111111111111111111111111111111111100000000000000000000000000000000000000000000011111
101C0000C0000C0111111111111111111111111111111111111111111111111111111100000000000000000000000000000000000000000000011111
101C0000C0000C0111111111111111111111111111111111111111111111111111111100000000000000000000000000000000000000000000011111
101C0000C0000C0111111111111111111111111111111111111111111111111111111100000000000000000000000000000000000000000000011111
101C0000C0000C0111111111111111111111111111111111111111111111111111111100000000000000000000000000000000000000000000011111
101C0000C0000C0111111111111111111111111111111111111111111111111111111100000000000000000000000000000000000000000000011111
101C0000C0000C0111111111111111111111111111111111111111111111111111111100000000000000000000000000000000000000000000011111
101C0000C0000C0111111111111111111111111111111111111111111111111111111100000000000000000000000000000000000000000000011111
101C0000C0000C0111111111111111111111111111111111111111111111111111111100000000000000000000000000000000000000000000011111
101C0000C0000C0111111111111111111111111111111111111111111111111111111100000000000000000000000000000000000000000000011111
101C0000C0000C0111111111111111111111111111111111111111111111111111111100000000000000000000000000000000000000000000011111
101C0000C0000C0111111111111111111111111111111111111111111111111111111100000000000000000000000000000000000000000000011111
101C0000C0000C0111111111111111111111111111111111111111111111111111111100000000000000000000000000000000000000000000011111
101C0000C0000C0111111111111111111111111111111111111111111111111111111100000000000000000000000000000000000000000000011111
101C0000C0000C0111111111111111111111111111111111111111111111111111111100000000000000000000000000000000000000000000011111
101C0000C0000C0111111111111111111111111111111111111111111111111111111100000000000000000000000000000000000000000000011111
111111111111111111111111111111111111111111111111111111111111111111111111111111111111111111111111111111111111111111111111