11111111111111111111111111111111111111111111111111111111111111111111111
1E1C0000C0000C011111111111111111111111111111111111111111111111111111111
101000C0000P00100000000000000000000000000000000000000000000000000000001
1C000111111111100000000000000000000000000000000000000000000000000000011
101111C0000000000000000000000000000000000000000000000000000000000000001
10000111111110111111111111111111111111111111111111111111111111111111111
1001000000000C111111111111111111111111111111111111111111111111111111111
101C0000C0000C011111111111111111111111111111111111111111111111111111111
101111C0000000000000000000000000000000000000000000111111111111111111111
101111C0000000000000000000000000000000000000000000111111111111111111111
101111C0000000000000000000000000000000000000000000111111111111111111111
101111C0000000000000000000000000000000000000000000111111111111111111111
101111C0000000000000000000000000000000000000000000111111111111111111111
101111C0000000000000000000001111111111000000000000000000000011111111111
101111C0000000000000001000000000000000000000000000111111111111111111111
101111C0000000000000000000000000000000000000000000111111111111111111111
101111C0000000000000000000000000000000000000000000111111111111111111111
101111C0000000000000000000000000000000000000000000111111111111111111111
101111C0000000000000000000000000000000000000000000111111111111111111111
101111C0000000000000000000000000000000000000000000111111111111111111111
11111111111111111111111111111111111111111111111111111111111111111111111
11111111111111111111111111111111111111111111111111111111111111111111111
11111111111111111111111111111111111111111111111111111111111111111111111
11111111111111111111111111111111111111111111111111111111111111111111111
11111111111111111111111111111111111111111111111111111111111111111111111
11111111111111111111111111111111111111111111111111111111111111111111111
11111111111111111111111111111111111111111111111111111111111111111111111
11111111111111111111111110000000000000000000000000000000001111111111111
11111111111111111111111110000000000000000000000000000000001111111111111
11111111111111111111111110000000000000000000000000000000001111111111111
11111111111111111111111110000000000000000000000000000000001111111111111
11111111111111111111111110000000000000000000000000000000001111111111111
11111111111111111111111110000000000000000000000000000000001111111111111
11111111111111111111111111111111111111111111111111111111111111111111111
11111111111111111111111111111111111111111111111111111111111111111111111
11111111111111111111111111111111111111111111111111111111111111111111111
11111111111111111111111111111111111111111111111111111111111111111111111
11111111111111111111111111111111111111111111111111111111111111111111111
11111111111111111111111111111111111111111111111111111111111111111111111
11111111111111111111111111111111111111111111111111111111111111111111111
11111111111111111111111111111111111111111111111111111111111111111111111
11111111111111111111111111111111111111111111111111111111111111111111111
11111111111111111111111111111111111111111111111111111111111111111111111
11111111111111111111111111111111111111111111111111111111111111111111111
11111111111111111111111111111111111111111111111111111111111111111111111
11111111111111111111111111111111111111111111111111111111111111111111111
11111111111111111111111111111111111111111111111111111111111111111111111
11111000000010000000000000011111111110000000000000000000000111111111111
10111100000100000000001000000000000000000000000000111111111111111111111
10111100001000000000000000000000000000000000000000111111111111111111111
10111100000000000000000000000000000000000000000000111111111111111111111
10111100000000000000000000000000000000000000000000111111111111111111111
10111100000000000000000000000000000000000000000000111111111111111111111
10111100000000000000000000000000000000000000000000111111111111111111111
11111111111111111111111111111111111111111111111111111111111111111111111
11111111111111111111111111111111111111111111111111111111111111111111111